##################
###E##.#...#.##..#
##@@##...#....##.#
#@@#...###.#.#...#
#@#..##...#....#.#
#@#.#...#..#.##..#
#@#.#.##.#.##...##
#@#.#....#...##..#
#@#.##.##.##.#.#.#
#@#..#.##..#.#.#.#
#@@@##.#..#..#...#
###@@#..#..#.#.#.#
## #@##..#.#.#.#.#
##@@@.##.#.#..#..#
#@@##.#.....#...##
##################