##############
######E@#@@@.#
#######@@@#@##
#######.#.#@@#
# ####..#..#@#
#  #  ##..# @#
##   ## ## #@#
### #@@@@@@@@#
###@@@###.#.##
# @@###....###
##@###.#.#...#
#@@.....####.#
##############