#############
#####E#...###
# #  @@.#..##
#   ##@#..###
## # @@##..##
#   #@#..#..#
## #@@..#.###
#  #@##....##
####@#.#.##.#
# #@@#..#...#
#@@@##.#..#.#
#@####.##.#.#
#@..#...#.#.#
#@#.#.#.###.#
#@#...#.....#
#############