#####
#####
#E#.#
#@@@#
#.#@#
##@@#
# @##
##@##
# @@#
###@#
###@#
##@@#
# @##
##@.#
#####