##############
#E@@@#....#..#
##.#@..#.#.#.#
# ##@#.###.#.#
#  @@##.#....#
###@###.#.#.##
#@@@......#..#
##############