#########
#E#.....#
#@@.#.#.#
##@#.####
##@#.##.#
#@@.....#
#########