########
#E@@#..#
# #@@.##
## #@#.#
#  #@..#
##@@@#.#
########