#############
#E@...#.....#
##@#.#.####.#
#@@#........#
#############