############
#E@@@@..#..#
##.##@##..##
#..##@#..#.#
#.#@@@..##.#
##@@#.#....#
#@@#.#.#.#.#
#@#..#.#..##
#@@.#...#..#
##@#..#..#.#
##@..#..#..#
############