###############
###E  #@@@.#..#
##@@##@@#@#.#.#
# @#@@@#@@..#.#
##@#@##@@##.#.#
# @@@#@@##....#
# #.#@@#...#.##
##..#@#.#.##..#
##.#@@#..##.###
##.#@#.#......#
#..#@...#.#.#.#
#.#@@##.#..#..#
#.#@##..###.#.#
###@..#.......#
###############