##################
#E@@@#.##..#..####
##.#@@....#..#####
#..##@#.##..#.####
##..#@@#...#...###
#..###@@@#...##..#
##..#..#@.#.##..##
#..# ##@@#.....#.#
#.#  # @#..##.#..#
##  # #@#.#.#.##.#
#  #@@@@.#..#....#
# # @#.##.#.#.#.##
#  #@.###.....#..#
## #@#.#.###.##.##
#@@@@..#.....#...#
##################