###############
###############
###E  #########
##@@#  ########
# @#  # #######
##@.#    ######
#@@## # #######
###############