###################
#####E@#....###.###
#### #@@.#.###...##
#@@@ ##@#.#.#..#.##
#@#@#@@@#....##...#
#@#@@@#...##....###
###################