######
###E@#
## #@#
##  @#
#  #@#
###@@#
##@@##
#@@###
#@#.##
#@@..#
##@###
# @###
##@###
##@.##
#@@###
#@####
######