#############
#E #...####.#
#@#..#...#..#
#@.#..##...##
#@#..#..#.#.#
#@#.###.....#
#@#.##..#.#.#
#@#.####.#..#
#@@@.#.....##
#.#@#..#.#..#
##@@.#.#..#.#
# @##.#..##.#
##@#...#.#.##
# @..##..#..#
##@#.###.##.#
#@@.###.....#
#############