###########
####E@@@@@#
#####.#.#@#
#### #..#@#
###@@@##@@#
###@#@@@@##
##@@#.###.#
##@#......#
###########