#########
#E#....##
#@@#.#..#
##@...#.#
#########