##########
####E#...#
###@@.##.#
###@#....#
##########