############
#E#..#@@@###
#@##.#@#@.##
#@#..#@#@###
#@#.##@#@@##
#@@@@@@.#@.#
##.#.#.# @##
#...#..##@@#
##.#..## #@#
#...## #  @#
#.#..# ###@#
###.#  # #@#
##...# # #@#
###### #  @#
###### ###@#
######   #@#
###### #@@@#
#######@@#.#
############