#################
#E@#.#.....#.#..#
##@#.#.#.#....#.#
#@@....#..###...#
#################