####################
#E@##..#....##..##.#
##@...###.#..#.#...#
##@#.###.#.#....#.##
#@@#.........##....#
####################