##########
##E# @@@##
# @@#@#@@#
# #@@@##@#
##..##@@@#
#..#@@@###
#.#@@#...#
###@#.####
#@@@#..#.#
#@#..#.#.#
#@.#.#.#.#
#@#..#...#
#@.#...#.#
##########