###################
#E@#.....#..#.#####
##@@.#.#...#..#####
###@##.##.#..######
##@@#..#....#######
#@@#.####.#..######
#@#........#..#####
###################