########
####E@@#
# ####@#
# ## #@#
#  @@@@#
###@####
# #@@..#
# ##@#.#
#   @@##
# ###@.#
##@@@@##
#@@##..#
#@#...##
########