#########
#E@@#..##
###@..###
# @@#..##
##@#.#.##
##@#.#.##
#@@..#..#
#########