##############
#E@##.#...##.#
##@@@...##...#
####@##....#.#
###@@..##.#..#
###@#.#.#..#.#
#  @#.#.#.####
# #@#.#.#..###
##@@#....#..##
##############