###############
#E  #     ##  #
#@#   ### ### #
#@## ## #  ## #
#@.#     #    #
###############