###########
##E@@.....#
#  #@##.#.#
## #@@#.#.#
#  ##@#..##
##  #@.#..#
#  #@@#..##
## #@##.###
###@@#..#.#
#  @#.#.#.#
# #@#.#.#.#
# #@#.#...#
# #@#..#.##
# #@##.##.#
# #@@#..#.#
#  #@#.#..#
###@@...#.#
###@#.#...#
###########