#################
##E    #   ###  #
# @# ##  #  ### #
##@#    # #  #  #
# @### #   #  # #
##@@#  # # # #  #
###@##  ## # ## #
#@@@.##    #    #
#################