##########
###E #...#
##@@#..#.#
#@@#..#..#
#@#..#..##
#@@#.#.#.#
##@#.#.#.#
##@@.#...#
# #@#..#.#
# @@#.##.#
##@#..#..#
#@@.#..#.#
#@##..####
#@#.##.#.#
#@#..#...#
#@.#...###
#@#.#.#.##
#@#.....##
#@..#.#..#
##########