###########
#E@#@@@...#
##@#@#@####
# @#@#@@.##
##@#@##@#.#
# @@@.#@@.#
# #### #@##
##@@@@@@@.#
# @###.#.##
##@..#..###
# @##.#..##
##@.#.#.#.#
#@@#..#...#
#@#.#..#.##
#@@.#.#...#
##@#..##.##
##@.#..#..#
# @#.#.#.##
##@.....###
###########