#######
#E@.#.#
##@#..#
# @..##
##@#..#
# @@#.#
###@@##
#  #@@#
##  #@#
###@@@#
###@#.#
##@@.##
# @##.#
##@...#
# @#.##
##@.###
# @#..#
##@..##
#@@#..#
#######