###########
#E@@#@@@..#
# #@#@#@#.#
## @#@#@@##
###@#@##@##
###@@@.#@.#
##..#.#@@##
###..##@#.#
##..# #@..#
#..## #@###
#### @@@###
#   #@#..##
###@@@.#..#
#  @##..#.#
# #@###..##
##@@####..#
###########