#################
#################
######E##########
### @@@.#########
####@#.#.########
# #@@#.#..#######
# #@##.#.########
#@@@.#....#######
#################