#####
#E@@#
# #@#
##@@#
##@##
# @.#
##@##
#@@.#
#####