###########
##E  #  ###
#@@# ## # #
#@##  # # #
#@@.# #   #
##@##   ###
##@..# #..#
# @##.#.#.#
##@@#.#...#
###@#.#.#.#
###@#.##..#
#@@@#..##.#
#@#.#.#.#.#
#@#.......#
###########