###################
##E   #....#...#..#
# @###..##.#.#..#.#
##@@@..#....#.#.#.#
#..#@##..##.#.#...#
### @.#.#.#.#...#.#
# ##@##.#.#..#.#..#
#  #@.#.#.#.#...###
## #@#..#.#..##.###
#@@@@.#....#....###
###################