##################
#E@@.#@@@..###.#.#
###@#@@#@##....#.#
#  @#@##@.#.#.#..#
# #@@@#@@#..#...##
#  ##.#@#.#..#.#.#
# #  #@@...###...#
# ##@@@#.#.....#.#
#  #@##.#.#.##..##
####@@..#.#..###.#
# ###@#.#.##.#.#.#
#  # @@##.##.#...#
##   #@#..##..#.##
### # @#.###.##..#
######@#.###..##.#
######@..####....#
##################