#########
##E@@@@##
#  #.#@@#
##  # #@#
#  ##@@@#
###@@@#.#
# #@#..##
# @@##..#
##@#.#.##
##@#.##.#
#@@#.#..#
#@#....##
#@#.#####
#@#...###
#@..#####
#########