#########
###E  #.#
## @##..#
###@#..##
## @@.#.#
####@#..#
### @@.##
#####@#.#
#@@@#@#.#
#@#@@@..#
#########