###############
#E@@####.#.#..#
# #@####....#.#
# #@..#.#.#.#.#
##@@#.....#...#
###############