##############
##E ##..#..#.#
# @#...#.#...#
##@@#.#....###
###@....##..##
##############