################
#E #..####...#.#
#@#..####..#...#
#@..#.####.#.#.#
#@#...##..#..#.#
#@@#.####...#..#
##@.#.#...#.##.#
# @#....#..#...#
##@..#.#.#.#.###
# @####..###...#
##@..#.#.#.#.#.#
# @#...#.#...#.#
##@@##.#..###..#
# #@.#.#.##...##
#@@@###.....#..#
################