#####
#####
#####
#####
#####
#####
#####
###E#
##@@#
# @##
##@.#
##@##
##@.#
# @##
##@@#
###@#
#####