############
#E@@@#.#@@@#
##.#@@@@@#@#
#..######@@#
###@@@@@@@##
#  @#.###.##
# #@.#..#.##
# #@#..#..##
##@@.#.#.#.#
##@#.#.##..#
#@@#......##
############