###############
#E@@@.#......##
####@#..#.##..#
### @..#..#.#.#
## #@##.#...#.#
##@@@#..#####.#
#@@#..#.......#
###############