##########
####E@@@@#
#### ###@#
####  #@@#
######@@##
####  @###
##   #@@##
### # #@##
##  #@@@.#
#  ##@##.#
##  #@@###
#  # #@..#
###@@@@###
##@@##...#
##########