###################
#######E   #  #####
######@@# ## ######
#####@@##    ######
###################