##################
#E ##.#...#..#.###
#@#@@@..##..#....#
#@#@#@#.##.#..#.##
#@@@#@##...##.#..#
###.#@#..#...#.#.#
##..#@..#.#.##...#
# ## @#....##..#.#
#   #@#.#.#...#..#
# #@@@.##.######.#
##@@#.#..........#
##################