#################
##E#....###...#.#
# @#.#.###..#...#
##@#.#.....####.#
# @#.##.##.####.#
##@#...#.#..##..#
##@#.#.#.#.#...##
##@...#...##.#..#
#@@#.#.#.##..#.##
#@#....#....#...#
#################