###############
####E@#..#...##
#####@..##.#..#
####@@##...##.#
### @#...#..#.#
# ##@..#..#.#.#
#  #@#.#.#..#.#
## #@##.#.#.#.#
#  #@.#.#.#.#.#
# #@@##.#.#.#.#
# #@##..#...#.#
# #@#.#.#####.#
#@@@..#.......#
###############