###########
#E@@#..####
# #@@#.####
# ##@...###
#  #@##..##
# ##@.###.#
#  #@#@@@@#
# # @@@##@#
####.#..#@#
#  ## ##@@#
## #@@@@@##
##  @###..#
#  #@#..###
### @#.####
## #@#..###
#  #@@#.#.#
# # #@#...#
#@@@@@..#.#
###########