#####
#####
###E#
## @#
###@#
## @#
###@#
# @@#
##@##
# @.#
##@##
# @.#
##@##
#@@.#
#@#.#
#@#.#
#####