#######
#######
#######
###E#.#
## @@.#
#  #@##
## #@@#
##  #@#
## # @#
### #@#
# # #@#
# # @@#
#  #@##
# # @@#
#   #@#
#####@#
##@@@@#
#######