#########
#####E@@#
####  #@#
###  ##@#
#### #@@#
###  #@##
##  # @@#
#  # ##@#
###  ##@#
## # @@@#
#  ##@#.#
## #@@.##
#  #@#..#
##@@@#.##
#########