##########
#E@@@@.#.#
# #.#@#..#
##..#@#.##
##.#@@...#
##.#@##.##
###@@#...#
###@#.####
## @@@####
#####@####
####@@####
##########
##########
##########