#########
#E@@@#.##
##.#@..##
####@##.#
####@...#
###@@##.#
##@@###.#
# @#.#..#
##@#.####
# @#...##
##@#.##.#
##@#....#
#@@..##.#
#########