########
#####E@#
#### #@#
###@@@@#
########