##############
#E@@# #.#@@@##
###@#@@@#@#@@#
#  @@@#@#@ #@#
# #####@@@##@#
##@@@@@#.#  @#
# @#.#@### #@#
##@## @@@@##@#
##@@@#.##@##@#
##.#@@#.#@@@@#
#...#@#.#.##.#
##.# @#.#...##
# # #@#.###..#
# #@@@#..#..##
#  @#...###.##
###@####.#...#
#@@@.###...#.#
##############