#########
####E#..#
####@..##
##@@@#..#
#########