#################
#E#..#.#..##....#
#@##....#...#.#.#
#@#.###.#.#.#.#.#
#@#.....#.#.#.#.#
#@#.##.#.#....#.#
#@#.#..#.#.#.#..#
#@#..#.#.##.#.#.#
#@..#...........#
#################