###################
#E#@@@@@#.###.#...#
#@@@#.#@...#....#.#
#.#..#@@###..#.##.#
##..#@@##.####.#.##
#..##@#...##......#
#.#@@@..##...#.#.##
#.#@#.##...##...###
##@@.#...#.#..###.#
# @##..##.###.#...#
##@@#.###.##....#.#
# #@#..#....###.#.#
# @@#.#..#.#....#.#
##@#..###...#.##..#
#@@.#.##.#.#.#...##
#@#......#.#...#..#
#@###.#.##..##.#.##
#@..#.#...#.....###
###################