########
#E@@@#.#
##.#@@.#
#..##@##
##..#@@#
#..###@#
#.####@#
#.###@@#
#.###@##
#..#@@.#
#.##@#.#
###@@.##
##@@#..#
# @###.#
##@#####
# @@##.#
# #@##.#
##@@...#
########