####################
##E #..#....##.....#
##@#..#..#.#.#.#.#.#
# @@.#.##....##..#.#
# #@#.....#.#...##.#
# #@#.##.#.#..##...#
# #@#..#...###...#.#
##@@..####.....#..##
#@@##...##.#.#..#..#
####################