############
##E#......##
##@@#.###..#
# #@#.#..#.#
#@@@....#..#
#@###.###.##
#@#.##....##
#@..##.###.#
#@####..#..#
#@@.###...##
##@######..#
#@@..####.##
############