##############
#####E@.##...#
######@#..#.##
######@##....#
# ###@@.#.##.#
#  #@@##..#..#
# #@@#...#..##
#  @#..##..#.#
# #@#.#..#...#
# #@@@#.###.##
#  ##@#..#...#
# ## @##..##.#
#  ##@#.#.##.#
# #@@@#......#
##@@#..###.#.#
#@@#..#....#.#
##############