########
#E#@@@.#
#@#@#@##
#@#@#@@#
#@@@.#@#
#####@@#
# #@@@##
# @@#..#
##@#.#.#
##@#.#.#
# @#.#.#
##@#.#.#
##@@@.##
# ##@#.#
#@@@@..#
########