##################
#E@@@#####..#..#.#
# ##@####.#..#...#
####@####..#...#.#
##  @###.#.##.#..#
#  #@@@@@#.#..#.##
# #..#.#@@@@##..##
##..#.#####@#.#.##
##.#...##.#@#...##
##...##...#@#.#..#
###.#...## @#..#.#
###...##  #@#.##.#
######### #@##...#
#### ##   #@...#.#
## @@@## ##@##..##
###@#@@@@@@@..#..#
##################