#############
#E#.###..##.#
#@@@@#..#...#
##.#@#.#..#.#
#..#@#.#.#..#
###@@..#..#.#
# #@#.##.#..#
#@@@.#....#.#
#@#.#..#.#..#
#@@#..#..#.##
##@@@#.#.#..#
####@#.#..#.#
##@@@#..#.#.#
#@@###.#..#.#
#@#....#.##.#
#@@#.#..#...#
##@@#.#...###
# #@..###...#
#@@@#....#.##
#############