###############
#E@#.#.##....##
##@@@@.#..#.###
# ###@#..#...##
# @@@@.##..#..#
##@#.#...####.#
##@@#..#...#..#
###@#.#.##..#.#
# @@.#...#.##.#
##@#..#.#.....#
# @@##...#.##.#
# #@...#..#..##
###@##.##...###
#@@@#....#.####
###############