#####
#E#.#
#@..#
#@#.#
#@###
#@@.#
##@##
# @##
##@.#
##@##
# @.#
##@##
# @.#
##@##
#@@##
#####