###################
#E#....#..##......#
#@#.##..#.#.#.#.#.#
#@#.#.#......#..#.#
#@#....#.#.#.#.##.#
#@@#.###..#..#..#.#
##@#..#..###.###..#
#@@#.#..#..#....#.#
#@#..##.#.#.#.#.#.#
#@@#..#.#.#.##....#
##@#.#..#.#.#.##.##
# @#.#.#..#...#...#
##@..#...#..#...#.#
###################