###################
###E@#@@@##..#.#..#
## #@#@#@...#..##.#
#  #@@@#@#.##.#...#
# ###.##@.#...#.#.#
# ##..#@@#..#...#.#
#  ###@@#..###.#..#
##  @@@#.#..#..#.##
## #@##..#.#..#...#
### @@@@#.###.###.#
## #.##@#..#..#...#
#   #@@@##..#..#.##
## #@@#..#.#..#..##
#  #@#.#.#.#.#.#..#
## #@..#....#...#.#
#  #@##.##.#..#.#.#
##@@@...#....#....#
###################