######
###E@#
####@#
##  @#
#  #@#
# #@@#
## @##
# #@@#
#  #@#
# ##@#
#  #@#
##@@@#
######