#################
#E#@@@@@@@..#...#
#@#@#####@#.#.#.#
#@@@#@@@@@#..#..#
#.#.#@#.#..#...##
##..#@.#.#..#.###
# #.#@#...###..##
#  #@@..##....###
## @@#.#..#.#..##
# #@#.#..#.#.#..#
#  @..#.##...####
# #@##..#..##...#
# #@#.#..#....#.#
# #@@..#.#####..#
## #@##........##
##@@@...#.##.#..#
#################