#####
##E##
# @@#
# #@#
##@@#
# @##
##@.#
# @##
##@##
#####