#####
#####
#####
#E@@#
# #@#
##@@#
# @##
##@.#
# @##
##@.#
#@@##
#####
#####