#########
#E#...#.#
#@#.#...#
#@@.#.#.#
##@#...##
#@@#.#..#
#@#...#.#
#@##.##.#
#@#..#..#
#########