####################
#E@@####.....##...##
# #@@.#..#.#.#..#..#
#  #@#..#.#..##..#.#
# # @#.#..#.#...##.#
#  #@#.##.#...#..#.#
# # @@@@#.##.#..#..#
#  ####@..#...#..#.#
## ## #@##.###..##.#
# #@@@#@@#.##..#.#.#
# #@#@ #@#..#.#..#.#
#  @#@#@@#.#...#.#.#
# #@#@#@##..#.#..#.#
## @#@#@.#.#....#..#
###@#@#@#..#####.#.#
##@@#@@@.#.........#
####################