###########
######E@#.#
##### #@..#
####@@@@#.#
###########